6 10 1
@@@.@@@@@@
@@@......@
@@.....$@.
@...@@@@@@
@W..@.....
@@@@@.....