10 10 1
....@...@@
@@.....@..
....@@....
....@..@@.
...@@$.@..
...@@@@@@.
.....@@...
.........@
...@@@@...
W.@@......