10 10 3
@@......@@
.....@..@.
..W...@.@.
....@@@...
....@....@
.@@@..@@..
...@@@...@
....@...@@
@@@@..@...
|.....@...
@@@..@..@@
..@....@@W
....@.....
...@@@@@@@
.@@.......
....@@@@@.
...@@@@@..
....@@@..@
..@@@@@.@@
..@|.....@
@@@@@@...@
....@W.@..
...@@@@...
...@....@@
.....@@...
....@@@@..
..@@@...@.
.@@@@....@
....@@.@.@
@@@....@.$